######## #######
#......###.....#
#..P...|.|.....#
#......###.....#
######## ###|###
          #.#
          #.#
          #.#
          #.#
          #.#
          #.#
###########.##################################################
#............................................................#
#............................................................#
#............................................................#
#............................................................#
#............................................................#
#............................................................#
#............................................................#
#............................................................#
#............................................................#
#............................................................#
#............................................................#
#............................................................#
#............................................................#
#............................................................#
##############################################################