####### #######
#.....###.....#
#.....|.|.....#
#.....###.....#
####### #######
